"aa" = (/turf/template_noop,/area/template_noop)
"ab" = (/obj/structure/cable/yellow{icon_state = "2-4"},/obj/structure/lattice/catwalk,/turf/template_noop,/area/template_noop)
"ac" = (/obj/structure/cable/yellow{icon_state = "4-8"},/obj/structure/lattice/catwalk,/turf/template_noop,/area/template_noop)
"ad" = (/obj/structure/cable/yellow{icon_state = "2-8"},/obj/structure/lattice/catwalk,/turf/template_noop,/area/template_noop)
"ae" = (/obj/item/stack/cable_coil/cut/yellow{amount = 2},/obj/structure/lattice/catwalk,/turf/template_noop,/area/template_noop)
"af" = (/obj/structure/cable/yellow{icon_state = "1-8"},/obj/structure/lattice/catwalk,/turf/template_noop,/area/template_noop)
"ag" = (/turf/closed/wall,/area/template_noop)
"ah" = (/obj/effect/spawner/structure/window/reinforced,/turf/open/floor/plating,/area/template_noop)
"ai" = (/obj/structure/cable/yellow{icon_state = "1-2"},/obj/structure/lattice/catwalk,/turf/template_noop,/area/template_noop)
"aj" = (/turf/open/floor/plating/airless,/area/template_noop)
"ak" = (/obj/scrappable/sleeper{icon_state = "sleeper"; dir = 4},/turf/open/floor/plasteel/white,/area/template_noop)
"al" = (/turf/open/floor/plasteel/white,/area/template_noop)
"am" = (/obj/structure/table,/obj/item/storage/firstaid/toxin{pixel_x = 3; pixel_y = 3},/obj/item/storage/firstaid/fire,/turf/open/floor/plasteel/white,/area/template_noop)
"an" = (/obj/structure/bed,/obj/item/bedsheet/black,/turf/open/floor/plasteel,/area/template_noop)
"ao" = (/turf/open/floor/plasteel,/area/template_noop)
"ap" = (/obj/machinery/door/airlock/external,/obj/structure/cable/yellow{icon_state = "1-2"},/turf/open/floor/plating,/area/template_noop)
"aq" = (/obj/machinery/door/poddoor{id = "onehalf_drone1ext"; name = "mining drone bay blast door"},/obj/effect/turf_decal/stripes/line{dir = 1},/turf/open/floor/plating/airless,/area/template_noop)
"ar" = (/obj/machinery/door/poddoor{id = "onehalf_drone2ext"; name = "mining drone bay blast door"},/obj/effect/turf_decal/stripes/line{dir = 1},/turf/open/floor/plating/airless,/area/template_noop)
"as" = (/obj/machinery/door/poddoor/preopen{id = "onehalf_drone3ext"; name = "mining drone bay blast door"},/obj/effect/turf_decal/stripes/line{dir = 1},/turf/open/floor/plating/airless,/area/template_noop)
"at" = (/obj/machinery/door/poddoor{id = "onehalf_drone4ext"; name = "mining drone bay blast door"},/obj/effect/turf_decal/stripes/line{dir = 1},/turf/open/floor/plating/airless,/area/template_noop)
"au" = (/obj/structure/lattice,/turf/template_noop,/area/template_noop)
"av" = (/obj/structure/table_frame,/turf/open/floor/plasteel/airless{icon_state = "damaged3"},/area/template_noop)
"aw" = (/obj/machinery/washing_machine,/turf/open/floor/plasteel/airless,/area/template_noop)
"ax" = (/obj/item/roller,/turf/open/floor/plasteel/white,/area/template_noop)
"ay" = (/obj/machinery/light{dir = 4},/obj/structure/table,/obj/item/storage/firstaid/brute{pixel_x = 3; pixel_y = 3},/obj/item/storage/firstaid/regular,/turf/open/floor/plasteel/white,/area/template_noop)
"az" = (/obj/machinery/light{dir = 8},/turf/open/floor/plasteel,/area/template_noop)
"aA" = (/obj/structure/cable/yellow{icon_state = "1-2"},/obj/machinery/light/small{dir = 8},/turf/open/floor/plating,/area/template_noop)
"aB" = (/obj/structure/disposalpipe/trunk,/turf/open/floor/plating/airless,/area/template_noop)
"aC" = (/obj/structure/disposalpipe/trunk,/obj/item/stack/ore/diamond/scrap,/turf/open/floor/plating/airless,/area/template_noop)
"aD" = (/obj/effect/turf_decal/stripes/line{dir = 1},/turf/open/floor/plating/airless,/area/template_noop)
"aE" = (/obj/item/stack/ore/iron/scrap,/turf/template_noop,/area/template_noop)
"aF" = (/turf/open/floor/plating/airless{icon_state = "platingdmg3"},/area/template_noop)
"aG" = (/turf/open/floor/plasteel/airless{icon_state = "damaged5"},/area/template_noop)
"aH" = (/obj/machinery/iv_drip,/turf/open/floor/plasteel/white,/area/template_noop)
"aI" = (/obj/structure/cable/yellow{icon_state = "2-4"},/turf/open/floor/plasteel/white,/area/template_noop)
"aJ" = (/obj/structure/cable/yellow{icon_state = "0-8"},/obj/structure/closet/crate/medical,/obj/item/clothing/neck/stethoscope,/obj/item/healthanalyzer,/obj/item/reagent_containers/blood/OMinus,/obj/item/reagent_containers/blood/OMinus,/obj/machinery/power/apc{dir = 4; name = "Crew Quarters APC"; pixel_x = 24},/turf/open/floor/plasteel/white,/area/template_noop)
"aK" = (/obj/structure/disposalpipe/segment,/obj/machinery/door/poddoor{id = "onehalf_drone1int"; name = "mining drone bay blast door"},/turf/open/floor/plating,/area/template_noop)
"aL" = (/obj/structure/disposalpipe/segment,/obj/machinery/door/poddoor{id = "onehalf_drone2int"; name = "mining drone bay blast door"},/turf/open/floor/plating,/area/template_noop)
"aM" = (/obj/structure/disposalpipe/segment,/obj/machinery/door/poddoor{id = "onehalf_drone3int"; name = "mining drone bay blast door"},/turf/open/floor/plating,/area/template_noop)
"aN" = (/obj/structure/disposalpipe/segment,/obj/machinery/door/poddoor{id = "onehalf_drone4int"; name = "mining drone bay blast door"},/turf/open/floor/plating,/area/template_noop)
"aO" = (/obj/structure/disposaloutlet{dir = 1},/obj/structure/disposalpipe/trunk,/turf/open/floor/plating/airless,/area/template_noop)
"aP" = (/obj/structure/lattice,/obj/item/storage/toolbox/syndicate,/turf/template_noop,/area/template_noop)
"aQ" = (/obj/structure/cable/yellow{icon_state = "1-2"},/turf/open/floor/plasteel/airless{icon_state = "damaged3"},/area/template_noop)
"aR" = (/turf/open/floor/plasteel/airless{icon_state = "damaged1"},/area/template_noop)
"aS" = (/obj/machinery/door/airlock/medical/glass,/obj/structure/cable/yellow{icon_state = "1-2"},/turf/open/floor/plasteel/white,/area/template_noop)
"aT" = (/obj/machinery/door/airlock,/turf/open/floor/plasteel,/area/template_noop)
"aU" = (/obj/structure/cable/yellow{icon_state = "1-4"},/obj/structure/cable/yellow{icon_state = "1-2"},/obj/effect/turf_decal/stripes/line{dir = 9},/turf/open/floor/plasteel,/area/template_noop)
"aV" = (/obj/structure/cable/yellow{icon_state = "0-8"},/obj/machinery/power/apc{dir = 1; name = "Mining Drone Bay APC"; pixel_y = 23},/obj/effect/turf_decal/stripes/line{dir = 1},/turf/open/floor/plasteel,/area/template_noop)
"aW" = (/obj/structure/disposalpipe/segment,/obj/effect/turf_decal/stripes/line{dir = 1},/turf/open/floor/plasteel,/area/template_noop)
"aX" = (/obj/machinery/button/door{id = "onehalf_drone2int"; name = "Drone 2 Internal Hatch Override"; pixel_x = 8; pixel_y = 27},/obj/machinery/button/door{id = "onehalf_drone2ext"; name = "Drone 2 External Hatch Override"; pixel_x = 8; pixel_y = 37},/obj/machinery/button/door{id = "onehalf_drone1int"; name = "Drone 1 Internal Hatch Override"; pixel_x = -8; pixel_y = 27},/obj/machinery/button/door{id = "onehalf_drone1ext"; name = "Drone 1 External Hatch Override"; pixel_x = -8; pixel_y = 37},/obj/effect/turf_decal/stripes/line{dir = 1},/turf/open/floor/plasteel,/area/template_noop)
"aY" = (/obj/effect/turf_decal/stripes/line{dir = 1},/turf/open/floor/plasteel,/area/template_noop)
"aZ" = (/obj/machinery/button/door{id = "onehalf_drone3int"; name = "Drone 3 Internal Hatch Override"; pixel_x = -8; pixel_y = 27},/obj/machinery/button/door{id = "onehalf_drone3ext"; name = "Drone 3 External Hatch Override"; pixel_x = -8; pixel_y = 37},/obj/machinery/button/door{id = "onehalf_drone4ext"; name = "Drone 4 External Hatch Override"; pixel_x = 8; pixel_y = 37},/obj/machinery/button/door{id = "onehalf_drone4int"; name = "Drone 4 Internal Hatch Override"; pixel_x = 8; pixel_y = 27},/obj/effect/turf_decal/stripes/line{dir = 1},/turf/open/floor/plasteel,/area/template_noop)
"ba" = (/obj/structure/disposalpipe/segment,/obj/effect/turf_decal/stripes/line{dir = 5},/turf/open/floor/plasteel,/area/template_noop)
"bb" = (/obj/item/stack/ore/iron/scrap,/turf/open/floor/plating/airless{icon_state = "platingdmg1"},/area/template_noop)
"bc" = (/obj/structure/disposalpipe/broken{dir = 4},/obj/item/stack/cable_coil/cut/yellow{amount = 2},/turf/open/floor/plating/airless{icon_state = "platingdmg2"},/area/template_noop)
"bd" = (/obj/structure/disposalpipe/segment{dir = 4},/obj/structure/cable/yellow{icon_state = "4-8"},/obj/structure/cable/yellow{icon_state = "1-4"},/turf/open/floor/plasteel/airless{icon_state = "damaged3"},/area/template_noop)
"be" = (/obj/structure/disposalpipe/segment{dir = 4},/obj/structure/cable/yellow{icon_state = "4-8"},/turf/open/floor/plasteel/airless{icon_state = "damaged5"},/area/template_noop)
"bf" = (/obj/structure/disposalpipe/segment{dir = 4},/obj/structure/cable/yellow{icon_state = "4-8"},/turf/open/floor/plasteel/airless,/area/template_noop)
"bg" = (/obj/structure/disposalpipe/junction{dir = 4},/obj/structure/cable/yellow{icon_state = "1-4"},/obj/structure/cable/yellow{icon_state = "4-8"},/turf/open/floor/plasteel/airless{icon_state = "damaged1"},/area/template_noop)
"bh" = (/obj/structure/disposalpipe/segment{dir = 4},/obj/structure/cable/yellow{icon_state = "4-8"},/obj/structure/cable/yellow{icon_state = "2-8"},/turf/open/floor/plasteel/airless,/area/template_noop)
"bi" = (/obj/structure/disposalpipe/junction{dir = 4},/obj/structure/cable/yellow{icon_state = "4-8"},/turf/open/floor/plasteel/airless,/area/template_noop)
"bj" = (/obj/structure/disposalpipe/segment{dir = 4},/obj/machinery/door/airlock/public/glass,/obj/structure/cable/yellow{icon_state = "4-8"},/turf/open/floor/plasteel,/area/template_noop)
"bk" = (/obj/structure/disposalpipe/segment{dir = 4},/obj/structure/cable/yellow{icon_state = "1-8"},/turf/open/floor/plasteel,/area/template_noop)
"bl" = (/obj/structure/disposalpipe/segment{dir = 4},/turf/open/floor/plasteel,/area/template_noop)
"bm" = (/obj/structure/disposalpipe/segment{dir = 4},/obj/structure/disposalpipe/segment,/turf/open/floor/plasteel,/area/template_noop)
"bn" = (/obj/structure/disposalpipe/segment{dir = 4},/obj/machinery/door/airlock/maintenance_hatch,/turf/open/floor/plasteel,/area/template_noop)
"bo" = (/obj/structure/disposalpipe/segment{dir = 4},/obj/machinery/light/small{dir = 1},/obj/effect/decal/cleanable/dirt,/turf/open/floor/plasteel,/area/template_noop)
"bp" = (/obj/structure/disposalpipe/junction/yjunction{dir = 1},/obj/effect/decal/cleanable/dirt,/turf/open/floor/plasteel,/area/template_noop)
"bq" = (/obj/structure/disposalpipe/trunk{dir = 8},/obj/machinery/disposal/bin,/turf/open/floor/plating,/area/template_noop)
"br" = (/obj/structure/disposalpipe/broken{dir = 4},/turf/open/floor/plating/airless{icon_state = "platingdmg3"},/area/template_noop)
"bs" = (/obj/structure/disposalpipe/segment{dir = 4},/turf/open/floor/plasteel/airless{icon_state = "damaged3"},/area/template_noop)
"bt" = (/obj/structure/disposalpipe/segment{dir = 4},/turf/open/floor/plasteel/airless,/area/template_noop)
"bu" = (/obj/structure/disposalpipe/segment,/obj/structure/disposalpipe/segment{dir = 4},/turf/open/floor/plasteel/airless{icon_state = "damaged1"},/area/template_noop)
"bv" = (/obj/structure/disposalpipe/segment{dir = 4},/obj/machinery/power/apc{dir = 2; name = "Hallway APC"; pixel_y = -23},/obj/structure/cable/yellow,/turf/open/floor/plasteel/airless,/area/template_noop)
"bw" = (/obj/structure/disposalpipe/segment{dir = 4},/turf/open/floor/plasteel/airless{icon_state = "damaged4"},/area/template_noop)
"bx" = (/obj/structure/disposalpipe/segment,/obj/structure/disposalpipe/segment{dir = 4},/turf/open/floor/plasteel/airless,/area/template_noop)
"by" = (/obj/machinery/door/airlock/public/glass,/obj/structure/disposalpipe/segment{dir = 4},/turf/open/floor/plasteel,/area/template_noop)
"bz" = (/obj/structure/disposalpipe/junction{dir = 8},/turf/open/floor/plasteel,/area/template_noop)
"bA" = (/obj/structure/disposalpipe/segment{dir = 4},/obj/machinery/light,/turf/open/floor/plasteel,/area/template_noop)
"bB" = (/obj/structure/disposalpipe/segment{dir = 9},/turf/open/floor/plasteel,/area/template_noop)
"bC" = (/obj/machinery/portable_atmospherics/canister/oxygen,/obj/effect/decal/cleanable/dirt,/turf/open/floor/plasteel,/area/template_noop)
"bD" = (/obj/effect/decal/cleanable/dirt,/turf/open/floor/plasteel,/area/template_noop)
"bE" = (/obj/structure/chair{dir = 4},/obj/effect/decal/cleanable/dirt,/turf/open/floor/plasteel,/area/template_noop)
"bF" = (/obj/structure/girder,/turf/open/floor/plating/airless,/area/template_noop)
"bG" = (/obj/structure/closet/emcloset,/turf/open/floor/plasteel/airless{icon_state = "damaged4"},/area/template_noop)
"bH" = (/obj/machinery/vending/coffee,/turf/open/floor/plasteel/airless{icon_state = "damaged4"},/area/template_noop)
"bI" = (/obj/machinery/vending/snack,/turf/open/floor/plasteel/airless{icon_state = "damaged2"},/area/template_noop)
"bJ" = (/obj/structure/disposalpipe/trunk{dir = 1},/obj/machinery/disposal/bin,/turf/open/floor/plasteel/airless,/area/template_noop)
"bK" = (/obj/structure/girder/reinforced,/obj/item/stack/sheet/plasteel,/turf/open/floor/plating/airless,/area/template_noop)
"bL" = (/obj/structure/girder/reinforced,/turf/open/floor/plating/airless,/area/template_noop)
"bM" = (/turf/closed/wall/r_wall,/area/template_noop)
"bN" = (/turf/open/floor/plasteel/airless{icon_state = "damaged2"},/area/template_noop)
"bO" = (/obj/structure/disposalpipe/segment,/turf/open/floor/plasteel/airless,/area/template_noop)
"bP" = (/obj/item/stack/ore/iron/scrap,/obj/item/stack/ore/plasma/scrap,/turf/template_noop,/area/template_noop)
"bQ" = (/turf/open/floor/plating/airless{icon_state = "platingdmg1"},/area/template_noop)
"bR" = (/obj/structure/disposalpipe/segment,/obj/item/stack/ore/iron/scrap,/turf/open/floor/plasteel/airless{icon_state = "damaged5"},/area/template_noop)
"bS" = (/obj/structure/grille,/turf/open/floor/plating/airless,/area/template_noop)
"bT" = (/obj/effect/spawner/structure/window/reinforced,/obj/machinery/door/poddoor/preopen{id = "bridge_onehalf"; name = "bridge blast door"},/turf/open/floor/plating,/area/template_noop)
"bU" = (/obj/structure/table/reinforced,/obj/item/flashlight/lamp,/turf/open/floor/plasteel,/area/template_noop)
"bV" = (/obj/structure/table/reinforced,/obj/item/paper,/obj/item/pen,/turf/open/floor/plasteel,/area/template_noop)
"bW" = (/obj/structure/closet/emcloset,/turf/open/floor/plasteel,/area/template_noop)
"bX" = (/obj/machinery/light{dir = 1},/obj/structure/frame/computer,/turf/open/floor/plasteel,/area/template_noop)
"bY" = (/obj/structure/frame/computer,/turf/open/floor/plasteel,/area/template_noop)
"bZ" = (/obj/structure/cable/yellow{icon_state = "0-4"},/obj/machinery/power/apc{dir = 1; name = "Bridge APC"; pixel_y = 23},/turf/open/floor/plasteel,/area/template_noop)
"ca" = (/obj/structure/cable/yellow{icon_state = "2-8"},/obj/structure/table/reinforced,/obj/item/stack/spacecash/c500{pixel_y = 8},/obj/item/stack/spacecash/c1000,/turf/open/floor/plasteel,/area/template_noop)
"cb" = (/obj/structure/disposalpipe/junction{dir = 1},/obj/item/stack/ore/glass/scrap,/turf/open/floor/plating/airless{icon_state = "platingdmg2"},/area/template_noop)
"cc" = (/obj/structure/lattice,/obj/structure/disposalpipe/broken{dir = 4},/obj/structure/disposalpipe/broken{dir = 8},/obj/item/stack/ore/iron/scrap,/turf/template_noop,/area/template_noop)
"cd" = (/obj/structure/lattice,/obj/structure/disposalpipe/segment{dir = 4},/obj/item/stack/ore/glass/scrap,/turf/template_noop,/area/template_noop)
"ce" = (/obj/effect/spawner/structure/window/reinforced,/obj/structure/disposalpipe/segment{dir = 4},/obj/machinery/door/poddoor/preopen{id = "bridge_onehalf"; name = "bridge blast door"},/turf/open/floor/plating,/area/template_noop)
"cf" = (/obj/structure/disposalpipe/segment{dir = 10},/obj/structure/table/reinforced,/obj/item/paper_bin{total_paper = 12},/turf/open/floor/plasteel,/area/template_noop)
"cg" = (/obj/structure/chair{dir = 8},/turf/open/floor/plasteel,/area/template_noop)
"ch" = (/obj/structure/chair{dir = 1},/turf/open/floor/plasteel,/area/template_noop)
"ci" = (/obj/structure/cable/yellow{icon_state = "1-4"},/obj/structure/cable/yellow{icon_state = "2-4"},/obj/structure/table/reinforced,/obj/item/lighter,/turf/open/floor/plasteel,/area/template_noop)
"cj" = (/obj/effect/spawner/structure/window/reinforced,/obj/structure/cable/yellow{icon_state = "0-4"},/obj/structure/cable/yellow{icon_state = "0-2"},/obj/structure/cable/yellow{icon_state = "0-8"},/obj/machinery/door/poddoor/preopen{id = "bridge_onehalf"; name = "bridge blast door"},/turf/open/floor/plating,/area/template_noop)
"ck" = (/obj/structure/lattice,/obj/item/stack/ore/iron/scrap,/obj/item/stack/ore/plasma/scrap,/turf/template_noop,/area/template_noop)
"cl" = (/obj/structure/lattice,/obj/item/stack/ore/glass/scrap,/turf/template_noop,/area/template_noop)
"cm" = (/obj/structure/disposalpipe/segment,/turf/open/floor/plasteel/airless{icon_state = "damaged5"},/area/template_noop)
"cn" = (/obj/structure/disposalpipe/trunk{dir = 1},/obj/machinery/disposal/bin,/turf/open/floor/plasteel,/area/template_noop)
"co" = (/obj/item/stack/tile/plasteel,/turf/open/floor/plasteel,/area/template_noop)
"cp" = (/obj/machinery/power/solar_control,/obj/structure/cable/yellow,/turf/open/floor/plasteel,/area/template_noop)
"cq" = (/obj/effect/spawner/structure/window/reinforced,/obj/structure/cable/yellow{icon_state = "0-2"},/obj/machinery/door/poddoor/preopen{id = "bridge_onehalf"; name = "bridge blast door"},/obj/structure/cable/yellow,/turf/open/floor/plating,/area/template_noop)
"cr" = (/obj/item/stack/tile/wood,/turf/template_noop,/area/template_noop)
"cs" = (/obj/structure/lattice,/obj/item/stack/cable_coil/cut/yellow{amount = 2},/turf/template_noop,/area/template_noop)
"ct" = (/obj/structure/lattice,/obj/structure/disposalpipe/broken{dir = 8},/obj/structure/disposalpipe/broken{dir = 1},/turf/template_noop,/area/template_noop)
"cu" = (/obj/machinery/door/airlock/command/glass{name = "Bridge"},/turf/open/floor/plasteel,/area/template_noop)
"cv" = (/obj/machinery/light/small,/turf/open/floor/plasteel,/area/template_noop)
"cw" = (/obj/machinery/door/poddoor/preopen{id = "bridge_onehalf"; name = "bridge blast door"},/obj/machinery/door/airlock/command/glass{name = "Bridge"},/turf/open/floor/plasteel,/area/template_noop)
"cx" = (/obj/item/crowbar/red,/obj/item/multitool,/turf/open/floor/plating,/area/template_noop)
"cy" = (/obj/structure/safe/floor,/obj/item/tank/internals/oxygen/red,/obj/item/clothing/mask/gas/syndicate,/obj/item/clothing/suit/space/hardsuit/syndi,/obj/item/reagent_containers/food/drinks/bottle/rum,/obj/item/reagent_containers/food/drinks/bottle/rum,/obj/item/folder/syndicate/mining,/turf/open/floor/plating,/area/template_noop)
"cz" = (/obj/structure/chair/comfy/black{dir = 4},/turf/open/floor/plasteel,/area/template_noop)
"cA" = (/turf/open/floor/plating/airless{icon_state = "platingdmg2"},/area/template_noop)
"cB" = (/obj/machinery/light{dir = 8},/obj/machinery/vending/sovietsoda,/turf/open/floor/plasteel,/area/template_noop)
"cC" = (/turf/open/floor/plasteel/airless{icon_state = "damaged3"},/area/template_noop)
"cD" = (/obj/structure/table/reinforced,/obj/machinery/recharger,/turf/open/floor/plasteel,/area/template_noop)
"cE" = (/obj/structure/chair/office,/turf/open/floor/plasteel,/area/template_noop)
"cF" = (/obj/machinery/button/door{id = "bridge_onehalf"; name = "Bridge Blast Door"; pixel_x = 32; pixel_y = 5},/turf/open/floor/plasteel,/area/template_noop)
"cG" = (/obj/structure/table/reinforced,/turf/open/floor/plasteel,/area/template_noop)
"cH" = (/obj/effect/spawner/structure/window/reinforced,/obj/structure/cable/yellow{icon_state = "0-4"},/obj/machinery/door/poddoor/preopen{id = "bridge_onehalf"; name = "bridge blast door"},/obj/structure/cable/yellow,/turf/open/floor/plating,/area/template_noop)
"cI" = (/obj/structure/cable/yellow{icon_state = "1-2"},/obj/structure/cable/yellow{icon_state = "2-8"},/obj/structure/lattice/catwalk,/turf/template_noop,/area/template_noop)
"cJ" = (/obj/structure/cable/yellow{icon_state = "1-2"},/turf/open/floor/plasteel/airless{icon_state = "damaged5"},/area/template_noop)
"cK" = (/obj/structure/table/reinforced,/obj/item/flashlight,/turf/open/floor/plasteel,/area/template_noop)
"cL" = (/obj/structure/table/reinforced,/obj/item/stack/ore/bluespace_crystal,/obj/item/coin/plasma,/turf/open/floor/plasteel,/area/template_noop)
"cM" = (/obj/structure/closet/firecloset/full,/turf/open/floor/plasteel,/area/template_noop)
"cN" = (/obj/machinery/light,/obj/structure/table/reinforced,/obj/item/storage/firstaid/regular,/turf/open/floor/plasteel,/area/template_noop)
"cO" = (/obj/structure/grille/broken,/obj/structure/cable/yellow{icon_state = "1-2"},/turf/open/floor/plating/airless{icon_state = "platingdmg1"},/area/template_noop)
"cP" = (/obj/structure/grille,/obj/item/stack/ore/glass/scrap,/turf/open/floor/plating/airless{icon_state = "platingdmg3"},/area/template_noop)
"cQ" = (/obj/effect/spawner/structure/window/reinforced,/obj/structure/cable/yellow{icon_state = "0-2"},/obj/structure/cable/yellow{icon_state = "0-4"},/obj/machinery/door/poddoor/preopen{id = "bridge_onehalf"; name = "bridge blast door"},/turf/open/floor/plating,/area/template_noop)
"cR" = (/obj/effect/spawner/structure/window/reinforced,/obj/structure/cable/yellow{icon_state = "0-4"},/obj/structure/cable/yellow{icon_state = "0-8"},/obj/machinery/door/poddoor/preopen{id = "bridge_onehalf"; name = "bridge blast door"},/turf/open/floor/plating,/area/template_noop)
"cS" = (/obj/effect/spawner/structure/window/reinforced,/obj/structure/cable/yellow{icon_state = "0-2"},/obj/structure/cable/yellow{icon_state = "0-8"},/obj/machinery/door/poddoor/preopen{id = "bridge_onehalf"; name = "bridge blast door"},/turf/open/floor/plating,/area/template_noop)
"cT" = (/obj/structure/lattice/catwalk,/obj/item/stack/ore/iron/scrap,/obj/item/stack/ore/plasma/scrap,/turf/template_noop,/area/template_noop)
"cU" = (/obj/structure/cable/yellow{icon_state = "4-8"},/obj/structure/lattice/catwalk,/obj/item/stack/ore/glass/scrap,/turf/template_noop,/area/template_noop)
"cV" = (/obj/structure/cable/yellow{icon_state = "4-8"},/obj/structure/cable/yellow{icon_state = "1-4"},/obj/structure/lattice/catwalk,/obj/item/stack/ore/iron/scrap,/turf/template_noop,/area/template_noop)
"cW" = (/obj/structure/cable/yellow{icon_state = "1-8"},/obj/structure/cable/yellow{icon_state = "4-8"},/obj/structure/lattice/catwalk,/turf/template_noop,/area/template_noop)
"cX" = (/obj/item/stack/cable_coil/cut/yellow{amount = 2},/turf/template_noop,/area/template_noop)

(1,1,1) = {"
aaaaaaaaaaaaaaaaaaaaaaaaaaaaaaaaaaaaaaaaaaaaaaaaaaaaaaaaaaaaaaaa
aaaaaaaaaaaaaaaaaaaaaaaaaaaaaaaaaaaaaaaaaaaaaaaaaaaaaaaaaaaaaaaa
aaaaaaaaaaaaaaaaaaaaaaaaaaaaaaaaaaaaaaaaaaaaaaaaaaaaaaaaaaaaaaaa
aaaaaaaaaaaaaaaaaaaaaaaaaaaaaaaaaaaaaaaaaaaaaaaaaaaaaaaaaaaaaaaa
aaaaaaaaaaaaaaaaaaaaaaaaaaaaaaaaaaaaaaaaaaaaaaaaaaaaaaaaaaaaaaaa
aaaaaaaaaaaaaaaaaaaaaaaaaaaaaaaaaaaaaaaaaaaaaaaaaaaaaaaaaaaaaaaa
aaaaaaaaaaaaaaaaaaaaaaaaaaaaaaaaaaaaaaaaaaaaaaaaaaaaaaaaaaaaaaaa
aaaaaaaaaaaaaaaaaaaaaaaaaaaaaaaaaaaaaaaaaaaaaaaaaaaaaaaaaaaaaaaa
aaaaaaaaaaaaaaaaaaaaaaaaaaaaaaaaaaaaaaaaaaaaaaaaaaaaaaaaaaaaaaaa
aaaaaaaaaaaaaaaaaaaaaaaaaaaaaaaaaaaaaaaaaaaaaaaaaaaaaaaaaaaaaaaa
aaaaaaaaaaaaaaaaaaaaaaaaaaaaaaaaaaaaaaaaaaaaaaaaaaaaaaaaaaaaaaaa
aaaaaaaaaaaaaaaaaaaaaaaaaaaaaaaaaaaaaaaaaaaaaaaaaaaaaaaaaaaaaaaa
aaaaaaaaaaaaaaaaaaaaaaaaaaaaaaaaaaaaaaaaaaaaaaaaaaaaaaaaaaaaaaaa
aaaaaaaaaaaaaaabacacacacacacacacacadaaaaaaaaaaaaaaaaaaaaaaaaaaaa
aaaaaaaaaaaeacafagagagagagagahagagaiaaaaaaaaaaaaaaaaaaaaaaaaaaaa
aaaaaaaaajagagagagakalamaganaoanagapagaqagaragasagatagaaaaaaaaaa
aaaaaaauauauavawagakaxayagazaoanagaAagaBagaCagaBagaBagauagaDagaa
aaaaaaaaaEaFauaGagaHaIaJaganaoanagapagaKagaLagaMagaNagaaagaOagaa
aaaaaaaPajauaQaRagagaSagagagaTagagaUaVaWaXaWaYaWaZbaagagagahagag
aaaaaaaubbbcbdbebfbfbgbebebhbfbibjbkblbmblbmblbmblbmblbnbobpbqah
aaaaaaaabrbsbsbtbtbsbubtbtbvbwbxbyblblbzbAbzblbzbAbBaoagbCbDbEah
aaaaaaaabFajagbGbHbIbJbKbLbMbNbObMbMbMbMbMbMbMbMbMbMbMagagahagag
aaaaaaaaaabPbQbFagbLbMajaubMbQbRbSaabTbUbVbWbXbYbZcabMauaaaaaaaa
aaaaaaaaaaaaaaaaaabLaaaaaEauaucbcccdcecfcgaochaoaocicjadaaaaaaaa
aaaaaaaaaaaaaaaaaEajckaaaaajclcmbLbMbMcnaocoaoaoaocpcqaiaaaaaaaa
aaaaaaaaaaaaaaaaaaaaaucraaaacsctcucvcwaococxcyaoczbYcqaiaaaaaaaa
aaaaaaaaaaaaaaaaaaaaaaaEauajcscAbMbMbMcBaoaoaoaoaobYcqaiaaaaaaaa
aaaaaaaaaaaaaaaaaaaaaaaEcraucscCahaubTcDcgaocEaocFcGcHcIaaaaaaaa
aaaaaaaaaaaaaaaaaaaaaEaaaabMcJaGahaabTcKcLcMbYbYaocNbMaiaaaaaaaa
aaaaaaaaaaaaaaaaaaaabLaucAbLcOcPbMbMbMbMcQcRcRcRcSbMbMaiaaaaaaaa
aaaaaaaaaaaaaaaaaaaaaaaacTcUcVacacacacaccWacacaccWacacafaaaaaaaa
aaaaaaaaaaaaaaaaaaaaaacXaaaaaaaaaaaaaaaaaaaaaaaaaaaaaaaaaaaaaaaa
"}
